1111111111
1200000001
1000000001
1000000001
1000000001
1000000001
1000000001
1000000001
1000000091
1111111111